__________
__GGGGGG__
__BBBBBB__
__RRRRRR__
__________