____RR____
___GGGG___
__BBBBBB__
_RRRRRRRR_
GGGGGGGGGG